1111111111111111111111111111111111
10E1000000000000000000000000000001
11000101001000001C1001000000010101
1010010010101010001001000000011101
100000000000000000000000000000P011
1111111111111111111111111111111111