11111111111
100PCE11111
11111111111