111111111111111111111
10000000000000C111111
1000C000000000C111111
10000000000000C111111
10000000000000C111111
1000C000000000C111111
1000000000000PC111111
100000000000000111111
100000000000000111111
100000000000000111111
1000C0000000000111111
100000000000000111111
100000000000000E11111
111111111111111111111